R 1080 720
F 0,200,0

NO ./textures/colorstone.xpm
SO ./textures/greystone.xpm
WE ./textures/bluestone.xpm
EA ./textures/purplestone.xpm
S ./textures/barrel.xpm
C 0,200,255

111111
100001
111111

11111111111111111111111
10000000000000000S00001
10111111111111111111111
10000000000000000000001
11111111111111111111121
10000000000000000000101
10000000000000000000101
10000000000000000000101
10000000000000000000101
10000000000000000020101
10000000000000000000101
10000000110110000200101
10000000122210002000101
10000000122210000200101
10000000111110000000101
10000000000000002200101
10000000000000002200101
10000000000000002200101
10000000000000000000101
10002000000000000000101
10000000000000000000001
11111111111111111111111
